#################################################################################
..........#.........#.........#.........#..............#..............#.........#
..........#.........#.........#.........#..............#..............#.........#
..........#.........#.........#.........#..............#..............#.........#
..........#.........#.........#.........#..............#..............#.........#
#....#....######....#....#....#....#....#....######....#....######....######....#
#....#.........#.........#....#....#....#....#.........#.........#..............#
#....#.........#.........#....#....#....#....#.........#.........#..............#
#....#.........#.........#....#....#....#....#.........#.........#..............#
#....#.........#.........#....#....#....#....#.........#.........#..............#
#....######....###########....######....#....#....######....#####################
#....#....#..............#....#.........#....#........................#.........#
#....#....#..............#....#.........#....#........................#.........#
#....#....#..............#....#.........#....#........................#.........#
#....#....#..............#....#.........#....#........................#.........#
#....#....###########....#....#....######....###########....######....#....#....#
#.........#....#.........#.........#.........#..............#....#.........#....#
#.........#....#.........#.........#.........#..............#....#.........#....#
#.........#....#.........#.........#.........#..............#....#.........#....#
#.........#....#.........#.........#.........#..............#....#.........#....#
###########....#....######....###########....#....###########....#....###########
#...................#..............#.........#....#...................#.........#
#...................#..............#.........#....#...................#.........#
#...................#..............#.........#....#...................#.........#
#...................#..............#.........#....#...................#.........#
#....################....#....######....######....#....################....#....#
#........................#..............#.........#........................#.....
#........................#..............#.........#........................#.....
#........................#..............#.........#........................#.....
#........................#..............#.........#........................#.....
#################################################################################