#################################################################################
....#.....#...#.........#...........#...........#...#.........#.....#.....#.....#
###.#.###.#.#.###.#####.#.#########.#.#######.#.###.#.#.###.###.###.#####.#.###.#
#.#.#...#.#.#.....#...#.#...#...#...#.......#.#.....#.#...#.....#...#.....#.#...#
#.#.###.#.#.#.#####.#.#.#####.#.#.#####.#####.###########.#.#####.###.###.#.#.###
#.#.#.#.#.#.#.#.....#.#.#...#.#.#.......#.....#...........#.#.....#...#...#.#...#
#.#.#.#.#.###.#.#######.#.#.#.#.#######.#.#################.#.#####.###.###.###.#
#...#...#.....#.......#.#.#.#.#.#.....#.#.#.......#...#...#.#.#.....#...#.....#.#
#.#####.#############.#.###.#.#.###.#.###.#.#####.#.#.#.#.#.#.#.#####.###.#.#.#.#
#.#.....#.......#...#.......#.#.....#.#...#.#.....#.#.#.#...#.#.#.....#.#.#.#.#.#
#.###.#####.###.#.#.###.#############.#.###.#.#######.#####.#.#.#.#####.#.#.#.#.#
#.........#.#...#.#...#.#.............#...#.#.#.......#.....#...#.#.....#.#.#.#.#
#.#######.###.###.#####.#.#####.#########.#.#.#.#.#####.#########.#.###.#.#.###.#
#...#.....#.....#.........#...#.........#.#.#.#.#.....#.#.....#.#.....#...#.#...#
###.#.#####.###.###########.#.#########.#.#.#.#.#.###.#.#.###.#.#####.#####.#.###
#...#.....#.#.#.....#.......#.#.......#.#.#.#...#.#...#.#.#...#.#...#.....#.#.#.#
#.#######.#.#.#####.#####.#.#.#####.###.#.#.#####.#####.###.###.#.#.#####.###.#.#
#.#...#...#.....#...#.....#.#...#.....#...#...#.#...#...#...#...#.#.....#.#...#.#
#.#.#.#.#########.###.#########.###.#.#######.#.###.###.#.###.###.#######.#.###.#
#.#.#.#.........#.#...........#.#...#.#...........#...#.#.....#...#.......#.....#
#.#.#.#########.#.###.###.###.#.#.#.#.#.###.#########.#.#.###.#.###.#####.#####.#
#.#.#...#.......#.....#...#.#.#...#.#...#...#...#.....#.....#.#.....#...#.#...#.#
#.#.###.#.#######.#####.###.#.#####.#########.#.#.#########.#.#######.#.#.#.#.###
#.#.#...#.....#...#...#...#.#...#...#.#.......#.#.......#...#.........#.#...#...#
#.#.#.#######.#.#.#.#.###.#.###.#.###.#.#######.#.###.###.#########.###.#######.#
#...#...#...#...#.#.#.#...#.....#.#.#.#.#...#...#.#.......#.#.....#...#...#.....#
#######.#.#.#####.###.#.#########.#.#.#.#.#.#.#.#.#.#######.#.###.#######.#.#####
#.#...#.#.#.......#...#.#.#.......#.#...#.#.#.#...#...#...#.#.#.#.....#...#.....#
#.#.#.#.#.#########.###.#.#.#.#####.#####.###.#######.#.#.#.#.#.#####.###.###.#.#
#...#...#...........#...#...#...........#.....#.........#...#...#.........#...#..
#################################################################################