#################################################################################
..#.......#.....#.....#.......#.......#...#.....#.......#.....#.........#.....#.#
#.#.#.###.#.###.#.#.###.#####.#.#####.#.#.#.###.#.#####.#.###.#.###.###.#.###.#.#
#.#.#.#.....#.#.#.#...#.....#.#.#...#...#.#.#...#...#.......#.#.#.#.#.#...#...#.#
#.#.#.#######.#.#.###.#.###.#.#.###.#.###.###.#####.#.#####.###.#.#.#.#####.###.#
#.#.#.#...#...#...#...#...#.#.#.#...#...#.#.......#.#...#.#.#...#...#.....#...#.#
#.#.#.#.#.#.#######.#####.#.#.#.#.#######.#.#.###.#.###.#.#.#.###########.###.#.#
#.#.#.#.#.#...#.#...#.....#.#...#...#.....#.#...#...#...#...#.#...#.....#.#.....#
#.#.#.#.#.###.#.#.###.###########.###.#####.###.#####.#######.#.###.#.###.#.#.###
#.#.#.#.#.#.........#.#...............#...#.#...#.#...#...#...#.#...#...#...#...#
#.#.#.#.###.#.###.###.#.#########.#####.###.#.###.#.###.#.#.###.#.#####.#######.#
#.#.#.#.#...#...#...#.#.....#...........#...#.....#...#.#.#...#.#.....#.........#
#.###.#.#.#####.###.#.#####.#####.###.###.###########.###.###.#.#####.#########.#
#.#...#.#.#.....#...#.#...#.....#.#...#...#...#.......#.....#.#.......#.....#...#
#.#.###.#.#.#####.###.#.#######.#.#.###.###.#.#.#######.#####.#########.#.#.#.###
#.#...#...#...#...#...#.........#.#...#.#.#.#.#...#...#.#...#.#...#.....#.#.#.#.#
#.###.#######.#.###.#############.#####.#.#.#.###.#.#.#.#.#.#.#.#.#######.###.#.#
#...#.#.....#.#.....#...........#.......#...#.#.#...#...#.#...#.#...#.....#...#.#
###.#.#.###.#.#######.#########.#########.###.#.#####.###.#.###.###.#.#.###.###.#
#...#.#.#.#...#...#...#.......#...........#...#.......#...#...#.#...#.#.#.......#
#.###.#.#.#.###.#.#.###.#####.#########.###.###.#######.#####.###.#####.#.#######
#.#...#.#.#.....#...#.....#...#.......#...#.#.#...#...#.#.......#.....#.#...#...#
#.#.###.#.#.#####.###.#####.###.#####.###.#.#.#.#.###.#.#####.#.#####.#.###.#.#.#
#.#...#.#.#...#...#...#.#...#.......#.....#...#.#.....#.....#.#.......#...#.#.#.#
#.###.#.#.###.#######.#.#.#########.#.#############.#.###.#.#.###########.#.###.#
#.....#.#.#.#.......#.#...#.........#.#.....#.....#.#...#.#.#.#...........#.#...#
#######.#.#.#######.#.#####.#########.#.###.#.###.#.###.###.#.#.###########.#.#.#
#...#...#.#.#.....#.......#.#.....#...#.#...#...#...#.#.#...#...#.......#...#.#.#
#.#.#.###.#.###.#.#######.#.#.###.#.#####.#####.#####.#.#.#######.#####.#.###.#.#
#.#.......#.....#.........#...#...#.......#...........#.........#.....#.......#..
#################################################################################